Wilhelm	Kern
Wendelin	Schobel
Heinrich	Kruse
Dominick	Ruhstaller
Anna	Redecker
Katharine	Neumann
Henriette	Wilking
Johann Georg	Frey
Friedericke	Speidel
Heinrich Wilhelm	Koester
Anna Katharine	Mayer
Wilhelm	Armand
Johanne Lucie Lisette	Eicksbusch
Anna Katharine	Klein
Gottlieb	Wolf
Henriette	Kleeberg
Louise	Beitinger
Friedrich	Riess
Friedericke	Eckhoff
Sophia Maria Engel	Loesche
Johann Theodor Ludwig	Gebhardt
Johanne Juliane Wilhelmine	Tuemler
Johann Friedrich Wilhelm	Schildmann
Peter	Fischer
Friedericke	Burghardt
Paul	Fischer
Sophia Wilhelmine Charlotte	Buck
Henriette Charlotte Louise	Bohne
Elisabeth	Laub
Andreas	Schreiber